R0000000000000000000000000000R
0000R0000000000000000000000000
0000RR00000000000GGGGGGGGGG000
00000R00000000000GGGGGGGGGG000
00000000RR0000000GGGGGGGGGG000
00000000RR0000000GGGGGGGGGG000
000RR000000000000GGGGGGGGGG000
00RRRR000000000000000000000000
0BBBBBBBBBB7B00000000000000000
0B00000000B0000000000000000000
0B0B00PO00B0B00000000000000000
0B0BBBBBBBB0B0000000000RR00000
0B0000000000B0000000RRRRR00000
0BBBBBBBBBBBB00000000R00000000
000000000000000000000000000000
000000000000000000000000000000
00000000000000GGGGGGGGGGGGGGGG
00000000000000GGGGGGGGGGGGGGGG
00000000000000GGWWWWWWWWWWWWWW
00000000000000GGWWWWWWWWWWWWWW
GGGGGGGGGGGGGGGGWWGGGGGGGGGGGG
GGGGGGGGGGGGGGGGWWGGGGGGGGGGGG
WWWWWWWWWWWWWWWWWWGG00000PP000
WWWWWWWWWWWWWWWWWWGG00000PP000
GGGGGGGGGGGGGGGGGGGG0000000000
GGGGGGGGGGGGGGGGGGGG0000000000
BBBBBBBBBBBBBBBBBBBB0000000000
0000OO000000000000000000000000
0000OO000000000000000000000000
R0000000000000000000000000000R
