RGGGGGGGGGGGGGGGGGGGGGGGGGGGGR
RGGGGGGGGGGGGGGGGGGGGGGGGGGGGR
RGGGGGGGGGGGGGGGGGGGG000000GGR
RGGGGRRGGGGGGGGGGGG0000000GGGR
RGGGRRRRGGGGGGGGGGGG000700GGGR
RGGGRRWWGGGGGGGGGGGGG0000GGGGR
RGGGGRWWGGGGGGGGGGBBBBBBBBBBBR
RGGGBBBBGGGBBBBBGGGGGGGGGGGGGR
RGGO00000GGGGGGGGGGGGGGBBBBBBR
RGG00000000GGGGGGGGGGG0000GGGR
RGG00000000GGGGGGGBBBBBBB00GGR
RGGGG000RRGGGGGGGGG0000000GGGR
RGGGGGGGRRGGGGGPGGGG00000GPGGR
RGGGGGGGRRGGGGGGGBBBBBBBGGGGGR
RGGGGGGRRRGGGGGGGGGGGGRRRGGGGR
ROGGGGGRRRGGGGGOGGGGGRRRRRGGGR
RGGGGGRRRGGGGGGGGGGGRRRRRRRGGR
RGGGGGRRRGGGG000GGGGRRRRRRRGGR
RGPGGGRRGGGG00000GGGRRRRRRRGGR
RGGGGGRRGGGGO000GGGGWRRRRRWGGR
RGGGGGRRGGGGGGGGGGGGWWRRRWWGGR
RGGGGGGGGGGGGGGGGGGGWWWWWWWGGR
RGGGGGGGGGGGGGGGGGPGGWWWWWGGGR
RGGGBBBBBBBGGGGGGGGGGGWWWGGGGR
RGGGGGGGGGGGGGGGG00GGGGWGGGGGR
RGGGGGGBBBBBBB000000GGGWGGGGGR
RGGGGRRRRRRRRGGPP0000GGWGGGGGR
RGGGRRRRRRRRRG000000GGGWGGGGGR
RGGGGPGGGGGGGGGGGGGGGGGWGGGOGR
RRRRRRRRRRRRRRRRRRRRRRRRRRRRRR